XXXXXXXXXXXXXXXXXXXXX
XS    X   X X       X
X X XXX X X X XXX X X
X X X   X X   X X X X
X XXX XXX XXX X XXX X
X           X X     X
XXXXX XXXXX X X XXX X
X   X X   X       X X
X XXX X X XXX XXX XXX
X X X X X   X X X X X
X X X X XXX XXX X X X
X   X X X           X
XXX XXX XXX XXXXX X X
X X       X X     X X
X X XXX X X XXXXXXX X
X X   X X X         X
X XXXXX XXX XXX XXX X
X           X     X X
X XXXXXXXXX XXXXXXX X
X       X          GX
XXXXXXXXXXXXXXXXXXXXX
